22 serialization::archive 16 0 0 23 0 0 23 0 2 1 0
0 0 -1 -1 -1 -1 0 0 0  0  0  0 0 0 0 0 0 0 0 1 0 1 1 0 0 1 0 0 0 0 2
1 1 -1 -1 -1 -1 0 0 0  0  0  0 0 0 0 0 0 0 0 1 1 1 0 1 0 1 0 0 0 0 2
2 2 -1 -1 -1 -1 0 0 0  0  0  0 0 0 0 0 0 0 0 1 0 1 0 0 1 1 1 0 0 0 2
3 3 -1 -1 -1 -1 0 0 0  0  0  0 0 0 0 0 0 0 0 1 0 1 0 0 0 1 0 1 1 1 2
4 4 -1 -1 -1 -1 0 0 0  0  0  0 0 0 0 0 0 0 0 0 1 1 0 0 0 1 0 0 0 0 2
5 5 -1 -1 -1 -1 0 0 0  0  0  0 0 0 0 0 0 0 1 0 0 1 0 0 1 1 0 1 0 0 2
6 6 -1 -1 -1 -1 0 0 0  0  0  0 0 0 0 0 0 0 0 1 1 1 0 0 0 0 0 0 0 1 2
7 7 -1 -1 -1 -1 0 0 0  0  0  0 0 0 0 0 0 0 0 1 0 1 1 0 0 0 0 0 0 0 2
8 8 -1 -1 -1 -1 0 0 0  0  0  0 0 0 0 0 0 0 1 0 0 1 0 0 0 0 0 0 0 0 2
9 9 -1 -1 -1 -1 0 0 0  0  0  0 0 0 0 0 0 0 0 1 1 1 0 0 0 0 0 0 0 0 2
10 10 -1 -1 -1 -1 0 0 0  0  0  0 0 0 0 0 0 0 0 1 0 1 0 1 1 1 1 0 0 0 2
11 11 -1 -1 -1 -1 0 0 0  0  0  0 0 0 0 0 0 0 0 0 1 1 0 0 0 1 0 0 0 1 2
12 12 -1 -1 -1 -1 0 0 0  0  0  0 0 0 0 0 0 0 0 0 0 1 0 0 0 0 1 0 0 1 2
13 13 -1 -1 -1 -1 0 0 0  0  0  0 0 0 0 0 0 0 0 1 1 1 0 1 0 0 0 0 0 1 2
14 14 -1 -1 -1 -1 0 0 0  0  0  0 0 0 0 0 0 0 0 1 1 1 0 0 0 0 0 0 0 1 2
15 15 -1 -1 -1 -1 0 0 0  0  0  0 0 0 0 0 0 0 1 0 0 1 0 0 1 1 0 0 0 0 2
16 16 -1 -1 -1 -1 0 0 0  0  0  0 0 0 0 0 0 0 0 0 0 1 0 1 0 1 0 0 1 1 2
17 17 -1 -1 -1 -1 0 0 0  0  0  0 0 0 0 0 0 0 0 0 1 1 0 0 0 1 0 1 0 0 2
18 18 -1 -1 -1 -1 0 0 0  0  0  0 0 0 0 0 0 0 0 1 0 1 0 0 1 1 0 0 1 1 2
19 19 -1 -1 -1 -1 0 0 0  0  0  0 0 0 0 0 0 0 1 0 0 1 0 0 0 1 0 0 0 0 2
20 20 -1 -1 -1 -1 0 0 0  0  0  0 0 0 0 0 0 0 0 1 0 1 0 0 0 1 0 0 1 0 2
21 21 -1 -1 -1 -1 0 0 0  0  0  0 0 0 0 0 0 0 0 1 0 1 0 0 0 1 1 0 0 0 2
22 22 -1 -1 -1 -1 0 0 0  0  0  0 0 0 0 0 0 0 0 1 0 1 1 0 0 1 0 0 0 0 0 0 23 62 0 0 0 1 0 5 1 2 1 5 1 6 2 3 2 6 2 7 2 8 3 4 3 8 3 9 4 9 4 10 5 6 5 11 6 7 6 11 6 12 7 8 7 12 7 13 8 9 8 13 8 14 9 10 9 14 10 14 10 15 11 12 11 16 11 17 12 13 12 17 12 18 13 14 13 18 13 19 13 20 14 15 14 20 14 21 15 21 15 22 16 17 17 18 18 19 19 20 20 21 20 22 21 22 3 5 3 14 3 17 5 14 14 17 15 20 2 12 2 13 6 8 6 13 8 12